Projection XOY:
A.........
+####.###.
.+.....#..
.#+.#####.
.##+#.###.
.###+##.#.
.####+###.
.####.+##.
.########.
..........

Projection XOZ:
A.........
+####.###.
.+#.#####.
..###.###.
.#.+#####.
..###.#...
..#..+###.
.####.+##.
..#...#.#.
..........

Projection YOZ:
A.........
.+.#..###.
..+##.###.
.#.+.#....
...######.
.#...+#...
.#..####..
.##.#####.
...#.####.
..........
