#...#....#..........
#....#....#....#....
.....##.........#...
..#.................
...#..........##....
.................#..
..........#......#..
...#.......#........
....#..........#....
......#........#....
.......#............
....................
....#.......#...##..
.....#.......#......
....................
.........##.........
....##..........##..
...................#
....................
.........##.........
