.................................#####..
.................................#####..
##....##############.....#.......#####..
##....##############.............#####..
.................................#####..
.................................#####..
.................................#####..
.................................#####..
......##.........................#####..
.#....##....##########A.....##...#####..
.#..........##########......##..........
.#..........##########......##..........
.#..........##########......##..........
.#..........##########......##..........
.#...#......##########......##..........
.#...#......##########......##..........
.#...#......##########......##.....##...
.#..........##########......##.....##...
.#..........##########......##.....##...
.#..........##########......##.....##...
.#..........##########......##.....##...
.#..........##########......##.....##...
.#....###...##########......##.....##...
.#....###...##########......##.....##...
.#....###...##########......##.....##...
.#....###...##########......##.....##...
.#....###...##########......##.....##...
.#....###...##########......##..........
.#....###...##########......##..........
.#....###...##########..................
.#....###...##########..................
.#....###...##########..................
.#....###...##########........#######...
.#....###...##########........#######...
.#....###...##########..................
.#....###...##########..................
.#....###...##########..................
.#....###...##########...###.......#....
.#....###...##########...###............
.#....###...##########...###............
......###...##########..................
......###...##########..................
......###...##########..................
......###...##########........#####.....
......###...##########..................
......###...##########..................
..#...###...##########..................
..#...###...##########..................
..#...###...##########...##############.
......###...##########...##############.
......###...##########...##############.
......###...##########...##############.
......###...##########...##############.
#.....###...##########...##############.
#...........##########...##############.
#...........##########...##############.
#...........##########...##############.
#...##...................##############.
#...##...................##############.
#...##...................##############.
#...##..........####....................
#...##..................................
#...##.....#............................
....##.....#................##........#.
......................................#.
......................................#.
................##....................#.
#####...#####...##...############.....#.
#####...#####...##...############.....#.
#####...#####...##...############.....#.
#####...#####........############.....#.
#####...#####........############.....#.
#####...#####........############.....#.
#####................############.......
#####...................................
#####...................................
#####...................................
#####...########....................##..
#####..........................#....##..
#####..........................#....##..
....................########........##..
........#...........########........##..
....................................##..
.##.................................##..
.##.............................#...##..
.##....############.............#...##..
.......############.............B...##..
.......############.....#####.......##..
.......############.....#####.......##..
.......############.....#####.......##..
...#...############.....#####.......##..
...#...############.....#####.......##..
...#...############.....#####.......##..
........................#####.......##..
........................#####...........
........................#####...........
....####........#####...................
................................####....
........................................
........................................
