....................................................................................................
......................................#............#......############..............................
.....#...###########..................#..#.........#................................................
.....#.........................#......#..#....................#................#......#.............
.....#..........#.............#...#...#..#....#......#........#.................#.....#.............
..A.............#............#....#...#..#.....#......#.......#...........#...........#.............
...+.####.......#...........#.....#...#..#......#......#......#..........#..........................
....+...........#.#####....#......#...#..#....#..#............#.........#...........................
.....+..........#.........#.......#...#..#...#....#...........#........#...........##########.......
...#..+.........#........#........#...#..#..#......#..........#.......#.............................
...#..#+......#.#.......#.........#...#..#.......#..#.......#.#......#.....#........................
.......#+.....#.#.................#...#..#......#....#......#.......#......#..................#.....
........#+....#.#..#.......#......#...#..#....#.......#............#............######.........#..#.
.........#+...#.#..#........#.........#..#....#........#..........#.............................#.#.
..........#+..#.#..#.....................#....#.........#........#..........#####.................#.
............+.#.#..#..........................#..#.......#......#...#..............##############.#.
............#+#.#.....#.....#################.#..#........#....#...#..............................#.
..#........#.+#.#......#......................#..#............#...#.......#####...............#...#.
...#......#..+#.#.......#.......##########....#..............#...#...................###......#...#.
....#....#...+#.#........#..................................#...#.............................#...#.
........#....+#.#..##.....#....................................#........................#.........#.
.......#.....+#.#..........#....#..###...#....................#..........................#........#.
.............+#.#...........#....#.......#...#...............#..###########.......##......#.......#.
......#.......++++++++++++++.#....#......#...#.........#....#........................#.....#......#.
......#........#............+.#........#.#...#........#....#.........................#......#.....#.
...#..#.......#..............+.#.......#.#...#.......#................###########....#.......#....#.
...#..#.....#.................+.#......#.#...#......#.....#..........................#........#...#.
...#.......#........#..........+.#.....#.#...#.....#..#....#.........................#............#.
..........#.........#..........#+.#....#.#...#....#....#....#........................#..............
.........#.....................#+..#...#.#...#..........#....#....#########......#..................
........#....################..#+...#....#...#....#......#....#..................#..................
.......#.......................#+....#...#...#...#........#....#.................#..#...............
..................#............#.+....#..#......#..........#....#................#...#..............
..................#............#..+....#.#.....#............#....#...............#........#.........
..................#............#...+.....#....#..............#....#..............#........#.........
.........##....................#....+....#...#................#....#.............#........#....#....
.............................#.#.....+......#.....#............#......#######....#........#....#....
.#...#######....#............#.#......+....#.....#...............................#........#....#....
.#.............#.............#.#...#...+..#.....#.....#.#........................#........#....#....
.#............#..............#.#...#....+#.....#.....#..#........................#........#....#....
.#...........#...........#...#.#...#.....+++++#.....#...#........................#........#....#....
.#..........#...........#....#.#...#..........++...#....#....#...#########.#.....#........#....#....
.#.........#...#....#..#.....#.#...#..........#.+.......#..#..#............#.....#....#...#....#....
.#............#....#..#......#.#...#..........#.#+......#..#...#...........#.....#....#...#....#....
.#...#.......#....#..#.......#.....#........#.#.#.+.....#..#....#..#.......#.....#....#........#....
.#...#......#....#..#...........#..#.......#..#.#..+....#..#.....#..#......#.....#....#....#...#....
.#...#.....#....#..#...#.......#...#......#.....#...+...#..#......#..#.....#.....#....#....#...#....
.#........#....#..#...#.......#....#.....#......#...#+..#..#..#....#..#....#.....#....#....#........
.#.......#....#..#...#..#....#..........#..#....#..#.+..#..#..#.....#..#...#..........#....#........
........#....#..#...#..#....#..........#..#..#....#..+..#..#..#......#.....#......#...#....#.##.....
.......#....#......#..#....#..........#..#..#....#...+..#..#..#.......#....#.....#....#....#........
......#....#......#..#...............#..#..#....#....+..#..#..#.#..........#....#.....#....#........
.....#....#......#..#...............#..#..#....#.....+..#..#.....#.........#...#......#....#........
....#....#......#..#...#..............#..#....#......+..#..#......#........#..#.......#....#........
...#....#......#..#...#..............#..#....#....#..+..#..#.................#........#..#.#........
.......#......#..#...#..............#..#....#......#.+..#...................#.........#..#.#........
......#.........#...#..............#..#.............#+..#..................#..........#..#.#........
.....#.........#..#...............#..#...............#+...................#...........#..#.#........
....#.........#..#...#.....#.....#..#.................#+...#......#......#.........#..#..#.#....#...
...#...#.....#..#....#.....#....#..#...................#+..#......#.....#.........#......#.#...#....
..#...#.....#........#.....#...#........................#+.#......#....#....#....#.......#.#..#.....
.....#.....#.........#.....#..#..........................#+...........#....#....#........#.#........
....#.....#..#.......#.....#......####################....#+.#.#####......#....#.........#.#.....#..
...#.....#..#........#..#..#...............................#+#...........#....#..........#......#...
..#.....#..#.........#...#.#................######..........+......#....#....#...........#.....#....
.......#..#..........#.....#.#############..................+......#...#....#..........#.#....#.....
......#..#...........#.....#...............####.......#####.#+..#..#..#....#...#......#..#...#......
..#..#..#............#.....#................................#.+..#...#....#....#.....#...#..#.......
...#.......########..#.....#...................#...#.#####..#.#+..#......#.....#....#......#........
....#................#.....#...................#...#........#.#+...#....#......#...#......#..#......
.....#......#####..........#..........#........#...#...#....#.#.+......#.......#..#......#...#......
......#....................#..........#........#.......#....#.#..+....#........#........#....#......
..#....#.............####..#..........#........#............#.#...+..#.........#.......#.....#......
..#.....#.........#..............#....#........#............#.#....+#..........#......#....#.#....#.
..#......#....#.#..#........#...#..............#.####.......#.#.....+++++++++++#.....#.....#.#....#.
..#..........#..#...#.......#.........###......#............#.#................+...........#.#......
..#.........#...#....#.........................#...#........#.#.................+####..#...#.#......
..#........#....#.....#.............#..#######.....#....#...#.#.........#.#......+.....#...#.#......
..#.......#.....#.......#.....#....#...............#...#....#.#.........#..#.....#+..........#......
..#......#......#........#.....#..#..........##....#..#.....#.#.........#...#...#.+.................
..#.....#.......#.........#......#.................#........#...........#......#..+...............#.
..#....#........#.....#............................#........#...........#.....#...+...............#.
..#...#.......#.#...#..#...........................#........#................#....+.................
..#...........#.#....#..#......................................#............#......+..########......
..#...........#.......#..#....................................#...#........#........+...............
..#.....#.....#........#..#.......####################.......#...#........#..........+..............
..#....#................#..#................................#............#........#...+###..........
......#..................#..#...........###########.....................#........#.....+++...#...#..
.....#.................#..#..#....#...................########.........#........#.........+..#...#..
..#.....................#..#..#....#..................................#........#..........#+.#...#..
..#......................#..#..#....#.........................#......#........#..........#.+.....#..
..#..#################....#..#..#....#...########.#########..#......#........#..........#..+.....#..
...........................#..#..#....#............................#........#..........#...#+....#..
..........############......#..#..#....#..#................................#...............#+....#..
.......#........................#..#....#..#.......####........##.##......#............#...#+....#..
......#..........................#..#....#..#............................#............#....#.+......
............#################.....#..#....#..#..........................#............#.....#..+.....
...................................#..#....#..#...............###......#.......................B....
....................###########...........................................................####......
....................................................................................................
