BB............................
BB............................
..###.....#.....#.....#.......
.......#...#.....#.....#......
.......#....#.....#.....#..#..
.......#.....#.....#.......#..
..#....#............#......#..
..#....#........#....#.....#..
..#....#....#....#....#....#..
..#....#.....#....#....#...#..
..#....#......#.........#..#..
..#....#..#....#..............
..#....#...#....#....#........
..#.........#....#....#....#..
..#..........#....#....#...#..
.....#........#....#....#..#..
......#........#....#.........
.......#......................
........#...#.................
.............#.AA#........#...
..............#AA#........#...
...#....###......#..#.....#...
....#................#....#...
.....#................#.......
........##########.....#......
..#.....................#.....
..#......................#....
..#....######..#######....#...
..............................
..............................
