BB............................
BB............................
++###.....#.....#.....#.......
+++....#...#.....#.....#......
.+++...#....#.....#.....#..#..
..+++..#.....#.....#.......#..
..#++..#............#......#..
..#++..#........#....#.....#..
..#+++.#....#....#....#....#..
..#.++.#.....#....#....#...#..
..#.+++#......#.........#..#..
..#..++#..#....#..............
..#..++#++.#....#....#........
..#..++++++.#....#....#....#..
..#...++++++.#....#....#...#..
.....#....+++.#....#....#..#..
......#....+++.#....#.........
.......#....+++...............
........#...#+++..............
.............#+AA#........#...
..............#AA#........#...
...#....###......#..#.....#...
....#................#....#...
.....#................#.......
........##########.....#......
..#.....................#.....
..#......................#....
..#....######..#######....#...
..............................
..............................
